11111111111111111111
10000000000000000001
10000000000000000001
10000000000000100001
10001111000000100001
10001001000000000001
10001001000000000001
10001001000000000001
10000000000000000001
10000000000000000001
10000000000000000001
10000010000000100001
10000000000001010001
10000000000000100001
10000000000000000001
10000000000000000001
10100000000000000001
10100000000010000001
10100000000000000001
11111111111111111111
