11111111111
11010101011
10000000001
11000000001
10000000001
10000000011
10000000001
10000000001
10010000001
10000000111
11111111111
