1111111111111111111111111111111111111111
1010000000001000000001000000000000000001
1010101111101001111001000111111111000001
1000101000001001001001000100000000000001
1111001000111001001001000111111111111111
1000001000000000001001110000000010000001
1111111000100111111001111010100010000001
1000000000100100000000000010100010000001
1111111111100111111000111010100011111001
1000000000100000001000100010100000001001
1000000000111111111000100010111111001001
1000000000000000000000100010001000001001
1111111111111111111111100011111000000001
1000000000000000000000011100000000000001
1000000000000000000000000000000000000001
1000000000000000000000000000000000000001
1000000000000000000000000000000000000001
1000000000000000000000000000000000000001
1000000000000000000000000000000000000001
1000000000000000000000000000000000000001
1000000000000000000000000000000000000001
1000000000000000000000000000000000000001
1000000000000000000000000000000000000001
1000000000000000000000000000000000000001
1000000000000000000000000000000000000001
1000000000000000000000000000000000000001
1000000000000000000000000000000000000001
1000000000000000000000000000000000000001
1000000000000000000000000000000000000001
1000000000000000000000000000000000000001
1000000000000000000000000000000000000001
1000000000000000000000000000000000000001
1000000000000000000000000000000000000001
1000000000000000000000000000000000000001
1000000000000000000000000000000000000001
1000000000000000000000000000000000000001
1000000000000000000000000000000000000001
1000000000000000000000000000000000000001
1000000000000000000000000000000000000001
1111111111111111111111111111111111111111
